11111111111111111111111
1CCCCCCCC0CPCCCCCCCCCC1
11111100111100101110101
101E0100111101000011001
1000000C000100C00000001
11111111111111111111111