11111111111111111111111
10000000000000000000001
10111100110100101110101
101E0100111101000011001
1110000C00010PC00000001
11111111111111111111111