11111111111111111111111
100000C00000CCCC0000001
10111100E10100101110101
10100100111001000010101
1110C00C00000PC000000C1
11111111111111111111111