11111111111111111111111
10E00000000000000000001
10111100110100101110101
10100100111101000011001
1110000C00010PC00000001
10111100011100101110101
10100100111001000010101
10111100010100101110101
10100100111001000010101
11111111111111111111111