11111111111111111111111
1CC1CCCCCCCCCCCCCCCCCC1
11111100111100101110101
101E0100111101000011001
1110000C00010PC00000001
11111111111111111111111