11111111111111111111111
10000000000000000000001
10111100E10100101110101
10100100111001000010101
1110000C00000PC00000001
11111111111111111111111