11111111111111111111111
100000C00000C0000000001
10111100010100101110101
10100100111001000010101
1P00C00C00000E0000000C1
11111111111111111111111