1111111111111
1E0100CCC00C1
1000011110001
1P00110000001
1111111111111